01100101
00111011
01111011
10001110
10110101
10010010
10110001
10111110
00010001
10000010
01001001
11011011
00100001
10010101
00001000
11110010
00010001
10000010
01001001
11011011
00100001
10010101
00001000
11110010
00110100
10000010
01001001
11011011
00100001
10010101
00001000
11110010
00110100
10000010
01001001
11011011
00100001
10010101
00001000
11110010
00110100
10000010
01001001
11011011
00100001
10010101
00001000
11110010
00110100
10000010
01001001
11011011
00100001
10010101
00001000
11110010
00110100
10000010
01001001
11011011
00100001
10010101
10001000
11110010
00110100
10000010
01001001
11011011
00100001
10010101
10001000
11110010
00110100
10000010
01001001
11011011
00100001
10010101
10001000
11110010
